____SBS__S__M__
____SSS_KSSSSSS
____MMP__S<>___
_TBT_____S_____
_TTT__+-_B_____
__MMMM___S__n__
VTBT_____S_____